..****..
........
........
...BW...
...WB...
........
........
........