..****..
........
..BBWW..
..BBWW..
..WWBB..
..WWBB..
........
........